Accessibility=Accessibility
Array=Array
AsBroadcaster=AsBroadcaster
AsUnit=com.asunit.framework.AsUnit
Assert=com.asunit.framework.Assert
Assertion=com.asunit.framework.Assertion
BevelFilter=flash.filters.BevelFilter
BitmapData=flash.display.BitmapData
BitmapFilter=flash.filters.BitmapFilter
BlurFilter=flash.filters.BlurFilter
Boolean=Boolean
Button=Button
Camera=Camera
Color=Color
ColorMatrixFilter=flash.filters.ColorMatrixFilter
ColorTransform=flash.geom.ColorTransform
Comparable=com.asunit.util.Comparable
ContextMenu=ContextMenu
ContextMenuItem=ContextMenuItem
ConvolutionFilter=flash.filters.ConvolutionFilter
CustomActions=CustomActions
Date=Date
DisplacementMapFilter=flash.filters.DisplacementMapFilter
DropShadowFilter=flash.filters.DropShadowFilter
Enumeration=Enumeration
Error=Error
EventListener=com.asunit.util.EventListener
EventSource=com.asunit.util.EventSource
ExternalInterface=flash.external.ExternalInterface
File=File
FileReference=flash.net.FileReference
FileReferenceList=flash.net.FileReferenceList
FontName=FontName
Function=Function
FunctionArguments=FunctionArguments
GlowFilter=flash.filters.GlowFilter
GradientBevelFilter=flash.filters.GradientBevelFilter
GradientGlowFilter=flash.filters.GradientGlowFilter
IME=System.IME
Key=Key
LoadVars=LoadVars
LocalConnClient=com.asunit.util.LocalConnClient
LocalConnGateway=com.asunit.util.LocalConnGateway
LocalConnServer=com.asunit.util.LocalConnServer
LocalConnection=LocalConnection
LocalMessageBroker=com.asunit.util.LocalMessageBroker
LocalOutputPanel=com.asunit.controls.LocalOutputPanel
LocalOutputPanelTest=com.asunit.controls.LocalOutputPanelTest
LocalOutputPanelTextArea=com.asunit.controls.LocalOutputPanelTextArea
LocalOutputPanelTextAreaTest=com.asunit.controls.LocalOutputPanelTextAreaTest
LocalOutputPanelTitleBar=com.asunit.controls.LocalOutputPanelTitleBar
Main=com.asunit.ui.Main
Math=Math
Matrix=flash.geom.Matrix
Microphone=Microphone
Mouse=Mouse
MovieClip=MovieClip
MovieClipLoader=MovieClipLoader
NetConnection=NetConnection
NetStream=NetStream
Number=Number
Object=Object
ObjectID=ObjectID
Observable=com.asunit.util.Observable
Point=flash.geom.Point
PrintJob=PrintJob
Rectangle=com.asunit.controls.shapes.Rectangle
Rectangle=flash.geom.Rectangle
Reflection=com.asunit.framework.Reflection
RemoteVersion=com.asunit.ui.RemoteVersion
ResizeHandle=com.asunit.controls.ResizeHandle
ScrollArrow=com.asunit.controls.ScrollArrow
ScrollHandle=com.asunit.controls.ScrollHandle
ScrollListener=com.asunit.controls.ScrollListener
Selection=Selection
SharedObject=SharedObject
Sound=Sound
Stage=Stage
String=String
StyleSheet=TextField.StyleSheet
SuccessMeter=com.asunit.ui.SuccessMeter
Sys=Sys
System=System
Test=com.asunit.framework.Test
TestCase=com.asunit.framework.TestCase
TestCaseXml=com.asunit.framework.TestCaseXml
TestFailure=com.asunit.framework.TestFailure
TestResult=com.asunit.framework.TestResult
TestRunner=com.asunit.framework.TestRunner
TestSetup=com.asunit.framework.TestSetup
TestSuite=com.asunit.framework.TestSuite
TextField=TextField
TextFile=com.asunit.util.TextFile
TextFormat=TextFormat
TextRenderer=flash.text.TextRenderer
TextScroller=com.asunit.controls.TextScroller
TextSnapshot=TextSnapshot
Transform=flash.geom.Transform
Triangle=com.asunit.controls.shapes.Triangle
URI=URI
Video=Video
XML=XML
XMLNode=XMLNode
XMLSocket=XMLSocket
XMLUI=XMLUI
capabilities=System.capabilities
security=System.security
