AS2Interop=flash.util.AS2Interop
AS2MovieClip=flash.util.AS2MovieClip
Accessibility=flash.accessibility.Accessibility
AccessibilityImplementation=flash.accessibility.AccessibilityImplementation
AccessibilityProperties=flash.accessibility.AccessibilityProperties
ActivityEvent=flash.events.ActivityEvent
AntiAliasType=flash.text.AntiAliasType
ApplicationDomain=flash.system.ApplicationDomain
ArgumentError=ArgumentError
Array=Array
BevelFilter=flash.filters.BevelFilter
Bitmap=flash.display.Bitmap
BitmapData=flash.display.BitmapData
BitmapDataChannel=flash.display.BitmapDataChannel
BitmapFilter=flash.filters.BitmapFilter
BitmapFilterQuality=flash.filters.BitmapFilterQuality
BitmapFilterType=flash.filters.BitmapFilterType
BlendMode=flash.display.BlendMode
BlurFilter=flash.filters.BlurFilter
Boolean=Boolean
ByteArray=flash.util.ByteArray
Camera=flash.media.Camera
Capabilities=flash.system.Capabilities
CapsStyle=flash.display.CapsStyle
Class=Class
ColorMatrixFilter=flash.filters.ColorMatrixFilter
ColorTransform=flash.geom.ColorTransform
ColorType=flash.text.ColorType
ContextMenu=flash.ui.ContextMenu
ContextMenuBuiltInItems=flash.ui.ContextMenuBuiltInItems
ContextMenuEvent=flash.events.ContextMenuEvent
ContextMenuItem=flash.ui.ContextMenuItem
ConvolutionFilter=flash.filters.ConvolutionFilter
CustomActions=macromedia.util.CustomActions
DataEvent=flash.events.DataEvent
DataFormat=flash.net.DataFormat
Date=Date
DefinitionError=DefinitionError
DisplacementMapFilter=flash.filters.DisplacementMapFilter
DisplacementMapFilterMode=flash.filters.DisplacementMapFilterMode
DisplayObject=flash.display.DisplayObject
DisplayObjectContainer=flash.display.DisplayObjectContainer
DropShadowFilter=flash.filters.DropShadowFilter
EOFError=flash.errors.EOFError
Endian=flash.util.Endian
Error=Error
ErrorEvent=flash.events.ErrorEvent
EvalError=EvalError
Event=flash.events.Event
EventDispatcher=flash.events.EventDispatcher
EventPhase=flash.events.EventPhase
EventRoot=flash.events.EventRoot
ExternalInterface=flash.external.ExternalInterface
FSCommand=flash.system.FSCommand
FileFilter=flash.net.FileFilter
FileReference=flash.net.FileReference
FileReferenceList=flash.net.FileReferenceList
FocusEvent=flash.events.FocusEvent
Font=flash.display.Font
FontStyle=flash.text.FontStyle
Function=Function
GlowFilter=flash.filters.GlowFilter
GradientBevelFilter=flash.filters.GradientBevelFilter
GradientGlowFilter=flash.filters.GradientGlowFilter
GradientType=flash.display.GradientType
Graphics=flash.display.Graphics
GridFitType=flash.text.GridFitType
HTTPStatusEvent=flash.events.HTTPStatusEvent
IDataInput=flash.util.IDataInput
IDataOutput=flash.util.IDataOutput
IEventDispatcher=flash.events.IEventDispatcher
IExternalizable=flash.util.IExternalizable
IME=flash.system.IME
IMEConversionMode=flash.system.IMEConversionMode
IMEEvent=flash.events.IMEEvent
IOError=flash.errors.IOError
IOErrorEvent=flash.events.IOErrorEvent
IllegalOperationError=flash.errors.IllegalOperationError
Infinity=Infinity
InteractiveObject=flash.display.InteractiveObject
InterpolationMethod=flash.display.InterpolationMethod
JointStyle=flash.display.JointStyle
KeyLocation=flash.ui.KeyLocation
Keyboard=flash.ui.Keyboard
KeyboardEvent=flash.events.KeyboardEvent
LineScaleMode=flash.display.LineScaleMode
Loader=flash.display.Loader
LoaderInfo=flash.display.LoaderInfo
LocalConnection=flash.net.LocalConnection
MMExecute=macromedia.util.MMExecute
Math=Math
Matrix=flash.geom.Matrix
MemoryError=flash.errors.MemoryError
Microphone=flash.media.Microphone
MorphShape=flash.display.MorphShape
Mouse=flash.ui.Mouse
MouseEvent=flash.events.MouseEvent
MovieClip=flash.display.MovieClip
NaN=NaN
Namespace=Namespace
NetConnection=flash.net.NetConnection
NetStatusEvent=flash.events.NetStatusEvent
NetStream=flash.net.NetStream
Number=Number
Object=Object
ObjectEncoding=flash.net.ObjectEncoding
ObjectInput=flash.util.ObjectInput
ObjectOutput=flash.util.ObjectOutput
Orientation=flash.print.Orientation
PixelSnapping=flash.display.PixelSnapping
Point=flash.geom.Point
PolicyFileEvent=flash.events.PolicyFileEvent
PrintJob=flash.print.PrintJob
ProductManager=macromedia.util.ProductManager
ProgressEvent=flash.events.ProgressEvent
Proxy=flash.util.Proxy
QName=QName
RangeError=RangeError
Rectangle=flash.geom.Rectangle
ReferenceError=ReferenceError
RegExp=RegExp
Responder=flash.net.Responder
ScriptTimeoutError=flash.errors.ScriptTimeoutError
Security=flash.system.Security
SecurityError=SecurityError
SecurityErrorEvent=flash.events.SecurityErrorEvent
SecurityPanel=flash.system.SecurityPanel
SetIntervalTimer=flash.util.SetIntervalTimer
Shape=flash.display.Shape
SharedObject=flash.net.SharedObject
SimpleButton=flash.display.SimpleButton
Socket=flash.net.Socket
Sound=flash.media.Sound
SoundChannel=flash.media.SoundChannel
SoundMixer=flash.media.SoundMixer
SoundTransform=flash.media.SoundTransform
SpreadMethod=flash.display.SpreadMethod
Sprite=flash.display.Sprite
StackOverflowError=flash.errors.StackOverflowError
Stage=flash.display.Stage
StageAlign=flash.display.StageAlign
StageQuality=flash.display.StageQuality
StageScaleMode=flash.display.StageScaleMode
StaticText=flash.display.StaticText
StatusEvent=flash.events.StatusEvent
String=String
StringBuilder=flash.util.StringBuilder
StyleSheet=flash.text.StyleSheet
SyncEvent=flash.events.SyncEvent
SyntaxError=SyntaxError
System=flash.system.System
TextEvent=flash.events.TextEvent
TextExtent=flash.text.TextExtent
TextField=flash.display.TextField
TextFieldAutoSize=flash.display.TextFieldAutoSize
TextFieldType=flash.display.TextFieldType
TextFormat=flash.text.TextFormat
TextFormatAlign=flash.text.TextFormatAlign
TextFormatDisplay=flash.text.TextFormatDisplay
TextLineMetrics=flash.text.TextLineMetrics
TextRenderer=flash.text.TextRenderer
TextRun=flash.text.TextRun
TextSnapshot=flash.text.TextSnapshot
Timer=flash.util.Timer
TimerEvent=flash.events.TimerEvent
Transform=flash.geom.Transform
TypeError=TypeError
URIError=URIError
URLLoader=flash.net.URLLoader
URLRequest=flash.net.URLRequest
URLRequestHeader=flash.net.URLRequestHeader
URLStream=flash.net.URLStream
URLVariables=flash.net.URLVariables
UninitializedError=UninitializedError
VerifyError=VerifyError
Video=flash.media.Video
XML=XML
XMLDocument=flash.xml.XMLDocument
XMLList=XMLList
XMLNode=flash.xml.XMLNode
XMLNodeType=flash.xml.XMLNodeType
XMLParser=flash.xml.XMLParser
XMLSocket=flash.net.XMLSocket
XMLTag=flash.xml.XMLTag
XMLUI=macromedia.util.XMLUI
clearInterval=flash.util.clearInterval
clearTimeout=flash.util.clearTimeout
decodeURI=decodeURI
decodeURIComponent=decodeURIComponent
describeType=flash.util.describeType
encodeURI=encodeURI
encodeURIComponent=encodeURIComponent
enterDebugger=flash.debugger.enterDebugger
escape=escape
flash_proxy=flash.util.flash_proxy
fscommand=flash.system.fscommand
getClassByAlias=flash.net.getClassByAlias
getClassByName=flash.util.getClassByName
getQualifiedClassName=flash.util.getQualifiedClassName
getTimer=flash.util.getTimer
heapDump=flash.profiler.heapDump
int=int
isFinite=isFinite
isNaN=isNaN
isXMLName=isXMLName
navigateToURL=flash.net.navigateToURL
parseFloat=parseFloat
parseInt=parseInt
profile=flash.profiler.profile
registerClassAlias=flash.net.registerClassAlias
sendToURL=flash.net.sendToURL
setInterval=flash.util.setInterval
setTimeout=flash.util.setTimeout
shl=flash.util.shl
showRedrawRegions=flash.profiler.showRedrawRegions
shr=flash.util.shr
trace=flash.util.trace
uint=uint
undefined=undefined
unescape=unescape